3	3	0	3	3	0	3	3	0	3	3	0	3	3	3	3
3	1	5	1	1	5	1	1	5	1	1	5	1	3	3	3
1	1	5	1	1	5	1	1	5	1	1	5	1	1	1	3
5	5	4	4	4	4	4	4	4	4	4	4	4	5	5	3
1	1	4	4	4	4	4	4	4	4	4	4	4	1	1	3
5	5	4	4	4	4	4	4	4	4	4	4	4	5	5	3
5	5	4	4	4	4	4	4	4	4	4	4	4	5	5	3
1	1	4	4	4	4	4	4	4	4	4	4	4	1	1	3
5	5	4	4	4	4	4	4	4	4	4	4	4	5	5	3
0	0	5	1	1	5	1	1	5	1	1	5	1	1	1	3
3	3	5	1	1	5	1	1	5	1	1	5	1	3	3	3
3	3	3	3	3	3	3	3	3	3	3	3	3	3	3	3